https://en.wikibooks.org/wiki/Telugu/Common_Phrases

Telugu (Dravidian)
Translation 	Phrase 	Pronunciation 	IPA
Telugu 	తెలుగు

How are you
	/t̪elugu/
Hello 	నమస్కారము 	namaskaaramu 	/nəməskaːrəmu/
Good-bye 	శెలవు 	selavu 	/seləvu/
Please 	దయ చేసి 	Daya chesi 	/dəjə ʧeːsi/
Thank you 	ధన్యవాదములు 	Dhanyavaadamulu 	/d̪ʱənjəvaːd̪əmulu/
I; me 	నేను 	nenu 	/neːnu/
this 	ఇది 	idi 	/id̪i/
that 	అది 	adi 	/əd̪i/
yes 	అవును 	avunu 	/avunu/
true 	నిజమె 	nizame 	/nizəːme/
no; not that 	కాదు 	kaadu 	/kaːd̪u/
English 	ఆంగ్లము 	Aanglamu 	/aːŋləmu/
Question Words i don't want talk to anyone
Translation 	Phrase 	Pronunciation 	IPA
what 	ఏంటి 	Enti 	/eːnʈi/
How 	ఎలా 	Ela 	/elaː/
Where 	ఎక్కడ 	Ekkada 	/ekəɖə/
When 	ఎప్పుడు 	epudu 	/epudu/
Who 	ఎవరు 	Evaru 	/evəru/
Which 	ఏది 	Edhi 	/eːd̪i/
How much 	ఎంత 	Entha 	/eŋt̪ə/
How many 	ఎన్ని 	Enni 	/enni/
Negative Words

    Do not want: Vaddhu (వద్దు)
    Do not have: Ledhu (లేదు)
    No, not that: Kaadhu /kaːdu/ ( కాదు )
    Don't know to do something: Raadhu /raːdu/ (రాదు)
    Not good: Baaledhu (బాలేదు)
    No idea: Teliyadhu (తెలియదు)
    I do not understand. : Naaku ardtham kaledhu ( నాకు అర్ధం కాలేదు )

General Conversation 1

    Language : Bhasha ( భాష )
    My name : "naa peru" ( నా పేరు )
    Where is the bathroom? : bathroom ekkada undhi? ( బాత్‌రూమ్ ఎక్కడ ఉంది? )
    How are you? : elaa Vunnaaru? ( ఎలా ఉన్నారు? )
    Where are we going? : ekkadiki veluthunam ? (ఎక్కడికి వెళ్తున్నాము?)
    What, where, why, when, who, how. : Enti, ekkada, endhuku, eppudu, evaru, elaa (ఏంటి, ఎక్కడ, ఎందుకు, ఎప్పుడు, ఎవరు, ఎలా)
    Had your meal? : "BhOjanam ayyindha?" (భోజనం అయ్యిందా?)
    What are you doing? : "Emi chEsthunnaaru?" (ఏమి చేస్తున్నారు?)
    It is there. : "undhi" (ఉంది)
    It is not present. : "lEdhu" (లేదు)
    I Like --- : "Naaku --- ishtam" ( నాకు ఇష్టం )
    I want --- : "Naaku --- kaavaali" ( నాకు కావాలి )
    I will go--I will come : "veltaanu--vastaanu" (వెళ్తాను -- వస్తాను)
    Year -- "Samvatsaram" (సంవత్సరం)
    Month -- "Maasam" (మాసం)
    Date -- "Thedhi" (తేది)
    New -- "Noothana" (నూతన)
    This is very good. -- "Idi chaalaa baagundhi" (ఇది చాలా బాగుంది)
    Where do you stay -- "Meeru ekkada untunnaaru" (మీరు ఎక్కడ ఉంటున్నారు?)
    I am watching a movie -- "Nenu cinema choosthunnanu" (నేను సినిమా చూస్తున్నాను)

"My father name" -- "Ma Nanna peru" "I love you" -- "Nenu ninnu premistunnanu"
General Conversation 2

    A : Hi, how are you? "Hi, ela unnaaru?"
    B : I am very well - how are you? "Nenu chaala baagunnanu - meeru ela unnaru?"
    A : Have you had lunch? "Lunch tinnaara"; (alternatively) Bhojanam chesara?; Lunch ayyindha?"
    B : I am going to a restaurant to have lunch. "Lunch tinadaaniki restaurant ki velthunna."

General Conversation 3
Verb form 	I/ Nenu 	We/ Memu (when you exclude the listener in we) 	We/ Manamu (when you include the listener in we) 	You/ Meeru (respectful reference) 	You/ Nuvvu (when you refer to peers/younger) 	He/ Aayana 	She/ Aavida 	It / Adi 	They/ Vaallu
Do 	chesth-aa-nu చేస్తాను 	chesth-aa-mu చేస్తూ ఉన్నాను 	chesth-aa-mu చేస్తాము 	chesth-aa-ru చేస్తారు 	chesth-aa-vu చేస్తావు 	chesth-aa-ru చేస్తారు 	chesth-aa-ru చేస్తారు 	chesth-undi చేస్తుంది 	chesth-aa-ru చేస్తారు
Doing 	chesth-oo-unna-nu చేస్తున్నాను 	chesth-oo-uuna-mu చేస్తున్నాము 	chesth-oo-unna-mu చేస్తున్నాము 	chesth-oo-unna-ru చేస్తున్నారు 	chesth-oo-unna-vu చేస్తున్నావు 	chesth-oo-unna-ru చేస్తున్నారు 	chesth-oo-unna-ru చేస్తూ ఉన్నారు 	chesth-oo-un-di చేస్తూ ఉంది 	chesth-oo-unna-ru చేస్తూ ఉన్నారు
Have done 	ches-ese-nu చేసేసాను 	ches-ese-mu చేసేసాము 	ches-ese-mu చేసేసాము 	ches-ese-ru చేసేసారు 	ches-ese-vu చేసేసావు 	ches-ese-ru చేసేసారు 	ches-ese-ru 	ches-ese-sindi 	ches-ese-ru
Have been doing(in Telugu all the forms are same as 'doing' but with time reference) 	chesth-oo-unna-nu 	chesth-oo-uuna-mu 	chesth-oo-unna-mu 	chesth-oo-unna-ru 	chesth-oo-unna-vu 	chesth-oo-unna-ru 	chesth-oo-unna-ru 	chesth-oo-un-di 	chesth-oo-unna-ru
